6 12
############
#$________I#
#_____$#___#
___D#__#____
#_________$#
#_##########